XXXXXXXXXXXXXXX
00000XXXXXXXXXX
XXXX00000000XXX
XXXXXXXXX0XXXXX
XXXXXXXXX0XXXXX
XXXXX00000000XX
XXXXX0XXXXXXXXX
XX0000000000XXX
XXXXX0XXXXX0XXX
XXXXX0XXXXX0XXX
XX000000XXX00XX
XX0XX0X0XXXXXXX
XX0XXXX0000XXXX
$00XXXXXXXXXXXX
XXXXXXXXXXXXXXX


