XXXXXXXXXXXXXXX
000XXX000XXX&45
X0XX000X0XXvvXX
X0XX0X000XXX..X
X00000XXX00000X
XXXXX00000XXX0X
XXXXXXXXXX0000X
X000000XXXXX0XX
XXXXX0XXXXXX0XX
X000000000000XX
XXX0X0X0X0XXXXX
XXX0XXXXXXXX0XX
XXX0XXXXXXXX0XX
X000000000000XX
XXXXXXXXX$XXXXX