XXXXXXXXXXXXXXXXXXXX
00000XXXX0XXXXXXXXXX
XXXX000000000XXX0XXX
XXXXXXXXXXXX00000XXX
XXXXXXXXXXXXXXXX0XXX
XXXXX000000000000X0X
XXXXX0XXXXXXXXXXXX0X
XX0000000000XXXXXX0X
XXXXX0XXXXX00000000X
XXXXX0XXXXXXXXXXXXXX
XX0000XXXX0000XXXXXX
XX0XX0XXXX0XXXXXXXXX
XX0XX000000XX0XX000X
XXXXXXXXXX0XX0000X0X
X00000XXXX0XXXXXXX0X
XXXXX000000000X0XX0X
XXX000XXXXX0X0X0XX0X
XXXXXX0XX000X000000$
XXXXXX0XXXXXX0X0X0XX
XXXXXXXXXXXXXXXXXXXX

