XXXXXXXX
0000000X
XXXXXX0X
XXX00X0X
XXXX0X0X
X000000X
XX0XX0XX
XX$XXXXX


