XXXXXXXX
0000000X
XXXXXX0X
X0000X0X
X0XX0X0X
X000000X
XXXXX0XX
XXXXXXXX